{
  "layout": [
    "11111111111111111111111111111111111111111111111111",
    "10000000000000000000000000000000000000000000000001",
    "10000000000000000000000000000000000000000000000001",
    "10000000000000000000000000000000000000000000000001",
    "10000000000000000000000000000000000000000000000001",
    "10000000000000000000000000000000000000000000000001",
    "10000000000000000000000000000000000000000000000001",
    "10000000000000000000000000000000000000000000000001",
    "10000000000000000000000000000000000000000000000001",
    "10000000000000000000000000000000000000000000000001",
    "10000000000000000000000000000000000000000000000001",
    "10000000000000000000000000000000000000000000000001",
    "10000000000000000000000000000000000000000000000001",
    "10000000000000000000000000000000000000000000000001",
    "10000000000000000000000000000000000000000000000001",
    "10000000000000000000000000000000000000000000000001",
    "10000000000000000000000000000000000000000000000001",
    "10000000000000000000000000000000000000000000000001",
    "10001101111101111101111101111101111101111101110001",
    "10001101111101111101111101111101111101111101110001",
    "10001101111101111101111101111101111101111101110001",
    "10001101111101111101111101111101111101111101110001",
    "10001101111101111101111101111101111101111101110001",
    "10001101111101111101111101111101111101111101110001",
    "10001101111101111101111101111101111101111101110001",
    "10001101111101111101111101111101111101111101110001",
    "10001101111101111101111101111101111101111101110001",
    "10001101111101111101111101111101111101111101110001",
    "10001101111101111101111101111101111101111101110001",
    "10001101111101111101111101111101111101111101110001",
    "10001101111101111101111101111101111101111101110001",
    "10001101111101111101111101111101111101111101110001",
    "10001101111101111101111101111101111101111101110001",
    "10001101111101111101111101111101111101111101110001",
    "10001101111101111101111101111101111101111101110001",
    "10001101111101111101111101111101111101111101110001",
    "10001101111101111101111101111101111101111101110001",
    "10001101111101111101111101111101111101111101110001",
    "10001101111101111101111101111101111101111101110001",
    "10000001000001000001000001000001000001000001000001",
    "10000000000000000000000000000000000000000000000001",
    "11000000000000000000000000000000000000000000000001",
    "10000000000000000000000000000000000000000000000001",
    "11111111111111111111111111111111111111111111111111"
  ],
  "start": { "x": 2, "z": 2, "rotation": 0 },
  "finish": { "x": 48, "z": 42 }
}
