{
  "layout": [
    "11111111111111111111111111111111111111111111111111",
    "10000100000000000000000000000000000000000000000001",
    "10000100000000000000000000000000000000000000000001",
    "10000100000000000000000000000000000000000000000001",
    "10000100000000000000000000000000000000000000000001",
    "10000100000000000000000000000000000000000000000001",
    "10000100000000000000000000000000000000000000000001",
    "10000100000000000000000000000000000000000000000001",
    "10000100000000000000000000000000111111111000000001",
    "10000110000000000000000000000001100000001100000001",
    "10000010000000000000000000000011000000000110000001",
    "10000011000000000000000000000110000000000011000001",
    "10000001000000000000000000000100000000000001000001",
    "10000001000000000000000000001100000000000001100001",
    "10000001000000000000000000001000000000000000100001",
    "10000001000000000000000000011000000000000000110001",
    "10000000110000000000000000010000000000000000010001",
    "10000000011000000000000000110000000000000000011001",
    "10000000001100000000000000100000000000000000001001",
    "10000000000011000000000000100000000000000000001001",
    "10000000000001110000000001100000000000000000001001",
    "11000000000000011100000011000000000000000000001001",
    "11000000000000000011100110000000000000000000000101",
    "10100000000000000000111100000000000000000000000101",
    "10110000000000000000000000000000000000000000000101",
    "10011000000000000000000000000000000000000000000101",
    "10001100000000000000000000000000000000000000000101",
    "10000011100000000000000000001111111000000000000101",
    "10000000111000000000000000111000001100000000000101",
    "10000000001110000000000001100000000100000000001101",
    "10000000000011110000000111000000000100000000001001",
    "10000000000000011111111100000000000100000000001001",
    "10000000000000000000000000000000000100000000001001",
    "10000000000000000000000000000000000100000000001001",
    "10000000000000000000000000000000000110000000001001",
    "10000000000000000000000000000000000010000000001001",
    "10000000000000000000000000000000000010000000001111",
    "10000000000000000000000000000000000011000000000011",
    "10000000000000000000000000000000000001100000000001",
    "10000000000000000000000000000000000000110000000001",
    "10000000000000000000000000000000000000011000000001",
    "10000000000000000000000000000000000000001000000001",
    "10000000000000000000000000000000000000001100000001",
    "11111111111111111111111111111111111111111111111111"
  ],
  "start": {
    "x": 1.5,
    "z": 1.5,
    "rotation": 0
  },
  "finish": {
    "x": 48.5,
    "z": 42.5
  }
}